11111111111111111111
10000000000000000001
10001000000000010001
10111111000011111101
10001000000000010001
10001000111100010001
10001000000000010001
10001001100110010001
10001000101100010001
10001000100100010001
10001000110100010001
10001001100110010001
10001000000000010001
10001000111100010001
10001000000000010001
10111111000011111101
10001000000000010001
10001000000000010001
10000000000000000001
11111111111111111111