11111111111111111111
10000000000000000001
10001000000000010001
10111111000011111101
10001000000000010001
10101000111100010101
10101000000000010101
10101001100110010101
10001000101100010001
10101000100100010101
10001000110100010001
10101001100110010101
10101000000000010101
10101000111100010101
10001000000000010001
10111111000011111101
10001000000000010001
10001001111110010001
10000000000000000001
11111111111111111111